15
inf
🧱🧱🧱🧱🧱🧱🍳🧱🧱🧱🧱🧱🧱🧱🧱🪹🧱
🧱🧱🟩🟩🟩🟩🟩🟩🟩🟩🟩🟩🟩🟩🧱🟩🧱
🧱🟩🟩🟩🟩🟩🟩🟩🟩🟩🟩🟩🟩🟩🧱🟩🧱
🧱🟩🟩🟩🟩🟩🟩🟩🟩🟩🟩🟩🟩🟩🧱🟩🧱
🧱🥚🟩🟩🟩🟩🟩🟩🧱🟩🧱🟩🟩🟩🍳🟩🧱
🧱🟩🟩🟩🟩🟩🪹🧱🟩🟩🟩🟩🟩🟩🧱🟩🧱
🧱🟩🟩🧱🧱🧱🧱🟩🟩🟩🟩🧱🟩🟩🧱🟩🧱
🧱🟩🟩🟩🟩🟩🧱🟩🟩🟩🟩🥚🧱🟩🧱🟩🧱
🍳🟩🟩🟩🧱🟩🍳🟩🟩🟩🪹🟩🟩🟩🪹🟩🧱
🧱🟩🟩🟩🧱🟩🟩🟩🟩🟩🥚🟩🟩🟩🧱🟩🧱
🪹🟩🟩🟩🍳🟩🟩🟩🟩🟩🟩🟩🟩🪹🧱🟩🧱
🧱🟩🟩🧱🧱🥚🟩🟩🟩🟩🪹🥚🟩🥚🍳🟩🧱
🧱🧱🟩🧱🧱🧱🧱🧱🪹🧱🧱🍳🍳🧱🧱🟩🧱
🧱🧱🟩🟩🟩🟩🟩🟩🟩🟩🟩🟩🟩🟩🟩🟩🧱
🧱🧱🧱🧱🧱🧱🧱🧱🧱🧱🧱🧱🧱🧱🧱🧱🧱