35
95
🧱🧱🧱🧱🧱🧱🧱🧱🧱🧱🧱🧱🧱🧱🧱🧱🧱🧱🧱🧱🧱🧱🧱🧱🧱🧱🧱🧱🧱🧱🧱🧱🧱🧱🧱🧱🧱🧱🧱🧱🧱🧱🧱🧱🧱🧱🧱🧱🧱
🧱🥚🧱🟩🟩🟩🧱🟩🟩🟩🟩🟩🟩🟩🟩🟩🟩🟩🧱🟩🟩🟩🟩🟩🟩🟩🧱🟩🟩🟩🟩🟩🟩🟩🟩🟩🟩🟩🟩🟩🟩🟩🟩🟩🟩🟩🟩🟩🧱
🧱🟩🧱🟩🧱🟩🧱🟩🧱🧱🧱🧱🧱🧱🧱🧱🧱🟩🧱🟩🧱🧱🧱🧱🧱🟩🧱🟩🧱🧱🧱🧱🧱🧱🧱🧱🧱🧱🧱🧱🧱🧱🧱🧱🧱🧱🧱🟩🧱
🧱🟩🟩🟩🧱🟩🧱🟩🧱🟩🟩🟩🟩🟩🟩🟩🟩🟩🧱🟩🧱🟩🟩🟩🟩🟩🧱🟩🧱🍳🧱🟩🟩🟩🟩🟩🟩🟩🟩🟩🟩🧱🟩🟩🍳🧱🟩🟩🧱
🧱🧱🧱🧱🧱🟩🧱🟩🧱🟩🧱🧱🧱🧱🧱🧱🧱🧱🧱🟩🧱🟩🧱🧱🧱🧱🧱🟩🧱🟩🧱🟩🧱🧱🧱🧱🧱🧱🧱🧱🟩🧱🟩🧱🧱🧱🟩🧱🧱
🧱🟩🟩🟩🟩🟩🧱🟩🧱🟩🧱🟩🟩🟩🧱🟩🟩🟩🧱🟩🧱🟩🧱🟩🟩🟩🟩🟩🟩🟩🟩🟩🟩🟩🟩🟩🟩🟩🟩🟩🟩🧱🟩🟩🟩🟩🟩🟩🧱
🧱🟩🧱🧱🧱🧱🧱🟩🧱🟩🧱🟩🧱🟩🧱🟩🧱🟩🧱🟩🧱🟩🧱🟩🧱🟩🧱🟩🧱🟩🧱🟩🧱🧱🧱🧱🧱🧱🧱🧱🟩🧱🟩🧱🧱🧱🧱🟩🧱
🧱🟩🟩🟩🟩🟩🟩🟩🧱🟩🧱🟩🧱🟩🧱🟩🧱🟩🧱🟩🧱🟩🧱🟩🧱🟩🧱🟩🧱🟩🧱🟩🧱🟩🟩🟩🟩🟩🟩🟩🟩🟩🟩🟩🟩🍳🧱🟩🧱
🧱🧱🧱🧱🧱🧱🧱🧱🧱🟩🧱🟩🧱🟩🧱🟩🧱🟩🧱🟩🧱🟩🧱🟩🧱🟩🧱🟩🧱🟩🧱🟩🧱🧱🧱🧱🧱🧱🧱🧱🧱🧱🟩🧱🧱🧱🧱🟩🧱
🧱🍳🟩🟩🟩🟩🟩🟩🟩🟩🟩🟩🧱🟩🟩🟩🧱🟩🧱🟩🧱🟩🧱🟩🧱🟩🧱🟩🧱🟩🟩🟩🟩🟩🟩🟩🟩🟩🟩🟩🟩🟩🟩🟩🟩🟩🧱🟩🧱
🧱🧱🧱🧱🧱🧱🧱🧱🧱🧱🧱🧱🧱🧱🧱🧱🧱🟩🧱🟩🧱🟩🧱🟩🧱🟩🧱🟩🧱🟩🧱🧱🧱🧱🧱🧱🧱🧱🧱🧱🧱🧱🧱🧱🧱🟩🧱🟩🧱
🧱🟩🟩🟩🟩🟩🟩🟩🟩🟩🟩🟩🟩🟩🟩🟩🟩🟩🟩🟩🧱🟩🧱🍳🧱🟩🧱🟩🧱🟩🧱🟩🟩🟩🟩🟩🟩🟩🟩🟩🟩🟩🟩🟩🧱🍳🧱🟩🧱
🧱🟩🧱🧱🧱🧱🧱🧱🧱🟩🧱🧱🧱🧱🧱🧱🧱🧱🧱🧱🧱🟩🧱🧱🧱🟩🧱🟩🧱🟩🧱🟩🧱🧱🧱🧱🧱🧱🧱🧱🧱🟩🧱🟩🧱🧱🧱🟩🧱
🧱🟩🟩🟩🟩🟩🟩🟩🧱🟩🧱🍳🟩🟩🟩🟩🟩🟩🟩🟩🟩🟩🟩🟩🟩🟩🧱🟩🧱🟩🧱🟩🧱🟩🟩🟩🟩🟩🟩🟩🟩🟩🧱🟩🟩🟩🧱🟩🧱
🧱🧱🧱🧱🧱🧱🧱🟩🧱🧱🧱🧱🧱🧱🧱🧱🧱🧱🧱🧱🧱🧱🧱🧱🧱🧱🧱🟩🧱🟩🧱🟩🧱🟩🧱🧱🧱🧱🧱🟩🧱🟩🧱🟩🧱🟩🧱🟩🧱
🧱🍳🟩🟩🟩🟩🟩🟩🟩🟩🟩🟩🟩🟩🟩🟩🧱🍳🟩🟩🟩🟩🟩🟩🟩🟩🟩🟩🧱🟩🧱🟩🧱🟩🧱🟩🟩🟩🟩🟩🧱🟩🟩🟩🧱🟩🧱🟩🧱
🧱🧱🧱🧱🧱🧱🧱🧱🧱🧱🧱🟩🧱🧱🧱🟩🧱🧱🧱🧱🧱🧱🧱🧱🧱🟩🧱🧱🧱🟩🧱🟩🧱🟩🧱🟩🧱🧱🧱🧱🧱🟩🧱🧱🧱🟩🧱🟩🧱
🧱🟩🟩🟩🟩🟩🟩🟩🟩🟩🟩🟩🟩🟩🟩🟩🧱🟩🟩🟩🟩🟩🟩🟩🟩🟩🧱🟩🟩🟩🧱🟩🧱🟩🧱🟩🟩🟩🟩🟩🟩🟩🧱🍳🧱🟩🧱🟩🧱
🧱🟩🧱🧱🧱🧱🧱🧱🧱🧱🧱🟩🧱🧱🧱🧱🧱🟩🧱🧱🧱🧱🧱🧱🧱🧱🧱🟩🧱🧱🧱🟩🧱🟩🧱🧱🧱🧱🧱🧱🧱🧱🧱🟩🧱🟩🧱🟩🧱
🧱🟩🟩🟩🟩🟩🟩🟩🟩🟩🟩🟩🟩🟩🟩🟩🟩🟩🧱🟩🟩🟩🟩🟩🟩🟩🟩🟩🟩🟩🟩🟩🟩🟩🟩🟩🟩🟩🟩🟩🟩🟩🟩🟩🧱🟩🟩🟩🧱
🧱🧱🧱🧱🧱🧱🧱🧱🧱🧱🧱🟩🧱🧱🧱🧱🧱🧱🧱🟩🧱🧱🧱🧱🧱🧱🧱🍳🧱🧱🧱🧱🧱🟩🧱🟩🧱🧱🧱🧱🧱🧱🧱🧱🧱🧱🧱🧱🧱
🧱🟩🟩🟩🟩🟩🟩🟩🟩🟩🟩🟩🟩🟩🟩🟩🟩🟩🟩🟩🟩🟩🟩🟩🟩🟩🧱🧱🧱🟩🟩🟩🧱🟩🟩🟩🟩🟩🟩🟩🟩🟩🟩🟩🟩🟩🟩🟩🧱
🧱🟩🧱🧱🧱🧱🧱🧱🧱🧱🧱🧱🧱🧱🧱🧱🧱🧱🧱🟩🧱🧱🧱🧱🧱🟩🧱🍳🧱🟩🧱🟩🧱🧱🧱🟩🧱🧱🧱🧱🧱🧱🧱🧱🧱🧱🧱🟩🧱
🧱🟩🧱🟩🟩🟩🟩🟩🟩🟩🟩🟩🟩🟩🟩🟩🟩🟩🟩🟩🟩🟩🟩🟩🟩🟩🟩🟩🧱🟩🧱🟩🧱🍳🧱🟩🟩🟩🟩🟩🟩🟩🟩🟩🟩🟩🟩🟩🧱
🧱🟩🧱🟩🧱🧱🧱🧱🧱🧱🧱🟩🧱🧱🧱🧱🧱🧱🧱🟩🧱🧱🧱🟩🧱🟩🧱🟩🧱🟩🧱🟩🧱🟩🧱🟩🧱🧱🧱🧱🧱🧱🧱🧱🧱🧱🧱🧱🧱
🧱🟩🧱🟩🧱🟩🟩🟩🟩🟩🟩🟩🟩🟩🟩🟩🟩🟩🟩🟩🟩🟩🟩🟩🧱🟩🧱🟩🧱🟩🧱🟩🧱🟩🧱🟩🧱🟩🟩🟩🟩🟩🟩🟩🟩🟩🟩🟩🧱
🧱🟩🧱🟩🧱🟩🧱🧱🧱🧱🧱🟩🧱🧱🧱🧱🧱🧱🧱🟩🧱🧱🧱🟩🧱🟩🧱🟩🧱🟩🧱🟩🧱🟩🧱🟩🧱🟩🧱🧱🧱🧱🧱🧱🧱🧱🧱🟩🧱
🧱🟩🧱🟩🧱🟩🧱🟩🟩🟩🟩🟩🟩🟩🟩🍳🧱🟩🟩🟩🟩🟩🟩🟩🧱🟩🟩🟩🟩🟩🧱🟩🧱🟩🧱🟩🟩🟩🧱🟩🟩🟩🟩🟩🟩🟩🧱🟩🧱
🧱🟩🧱🟩🧱🟩🧱🟩🧱🟩🧱🟩🧱🧱🧱🧱🧱🟩🧱🟩🧱🧱🧱🧱🧱🧱🧱🟩🧱🧱🧱🟩🧱🟩🧱🧱🧱🧱🧱🟩🧱🧱🧱🧱🧱🟩🟩🟩🧱
🧱🟩🟩🟩🧱🟩🧱🟩🧱🟩🧱🟩🧱🟩🟩🟩🟩🟩🧱🟩🧱🍳🟩🟩🟩🟩🟩🟩🟩🟩🧱🟩🧱🟩🟩🟩🟩🟩🟩🟩🧱🟩🟩🟩🟩🟩🧱🧱🧱
🧱🧱🧱🟩🧱🟩🧱🟩🧱🟩🧱🟩🧱🟩🧱🧱🧱🧱🧱🟩🧱🧱🟩🧱🧱🧱🧱🟩🧱🟩🧱🟩🧱🟩🧱🧱🧱🧱🟩🟩🧱🟩🧱🧱🧱🧱🧱🍳🧱
🧱🟩🟩🟩🟩🟩🧱🟩🧱🟩🧱🟩🟩🟩🟩🟩🟩🍳🧱🟩🟩🟩🟩🟩🟩🟩🧱🟩🧱🟩🟩🟩🟩🟩🟩🟩🟩🟩🟩🧱🧱🟩🟩🟩🟩🟩🟩🟩🧱
🧱🟩🧱🟩🧱🟩🧱🟩🧱🟩🧱🟩🧱🧱🧱🧱🧱🧱🧱🧱🟩🧱🧱🧱🧱🟩🧱🟩🧱🟩🧱🟩🧱🧱🧱🧱🧱🧱🧱🧱🧱🧱🧱🧱🧱🧱🧱🟩🧱
🧱🟩🟩🟩🧱🍳🧱🪹🧱🟩🟩🟩🟩🟩🟩🟩🟩🟩🟩🟩🟩🧱🍳🟩🟩🟩🟩🟩🟩🟩🧱🟩🟩🟩🟩🟩🟩🟩🟩🟩🟩🟩🟩🟩🟩🟩🟩🟩🧱
🧱🧱🧱🧱🧱🧱🧱🧱🧱🧱🧱🧱🧱🧱🧱🧱🧱🧱🧱🧱🧱🧱🧱🧱🧱🧱🧱🧱🧱🧱🧱🧱🧱🧱🧱🧱🧱🧱🧱🧱🧱🧱🧱🧱🧱🧱🧱🧱🧱