8
99
🧱🧱🧱🧱🧱🧱🧱🧱
🧱🟩🟩🥚🥚🥚🥚🧱
🧱🟩🟩🥚🥚🥚🥚🧱
🧱🟩🟩🥚🥚🥚🥚🧱
🧱🟩🟩🥚🥚🥚🥚🧱
🧱🟩🟩🟩🟩🟩🟩🧱
🧱🟩🟩🟩🟩🟩🟩🧱
🧱🧱🧱🧱🧱🧱🧱🧱