16
24
🧱🧱🧱🧱🧱🧱🍳🧱🧱🧱🧱🧱🧱🧱🧱🧱🧱
🧱🧱🟩🟩🟩🟩🟩🟩🟩🟩🟩🟩🟩🟩🧱🪹🧱
🧱🟩🟩🟩🟩🟩🟩🟩🟩🟩🟩🟩🟩🟩🧱🟩🧱
🧱🟩🟩🟩🟩🟩🟩🟩🟩🟩🟩🟩🟩🟩🧱🟩🧱
🧱🥚🟩🟩🟩🟩🟩🟩🧱🟩🧱🟩🟩🟩🍳🟩🧱
🧱🟩🟩🟩🟩🟩🪹🧱🟩🟩🟩🟩🟩🟩🧱🟩🧱
🧱🟩🟩🧱🧱🧱🧱🟩🟩🟩🟩🧱🟩🟩🟩🟩🧱
🧱🟩🟩🟩🟩🟩🧱🟩🟩🟩🟩🥚🧱🟩🟩🟩🧱
🧱🟩🟩🟩🟩🟩🧱🟩🟩🟩🟩🟩🍳🟩🟩🟩🍳
🪹🟩🟩🟩🧱🟩🍳🟩🟩🟩🪹🟩🧱🟩🪹🟩🧱
🧱🟩🟩🟩🧱🟩🟩🟩🟩🟩🥚🟩🟩🟩🧱🟩🧱
🧱🟩🟩🟩🍳🟩🟩🟩🟩🟩🟩🟩🟩🪹🧱🟩🧱
🧱🟩🟩🧱🧱🥚🟩🟩🟩🟩🪹🥚🟩🥚🍳🟩🧱
🧱🧱🟩🟩🧱🧱🧱🧱🍳🧱🧱🍳🍳🧱🧱🟩🧱
🧱🧱🟩🟩🟩🟩🟩🟩🟩🟩🟩🟩🟩🟩🟩🟩🧱
🧱🧱🧱🧱🧱🧱🧱🧱🧱🧱🧱🧱🧱🧱🧱🧱🧱