13
18
🧱🧱🧱🧱🧱🧱🍳🧱🧱🧱🧱🧱🪹🧱🧱
🧱🧱🟩🟩🟩🟩🟩🟩🟩🟩🟩🟩🟩🟩🧱
🧱🟩🟩🟩🟩🟩🟩🟩🟩🟩🟩🟩🟩🟩🧱
🧱🟩🟩🟩🟩🟩🟩🟩🟩🟩🟩🟩🟩🟩🧱
🧱🥚🟩🟩🟩🟩🟩🟩🧱🟩🧱🟩🟩🟩🍳
🧱🟩🟩🟩🟩🟩🪹🧱🟩🟩🟩🟩🟩🟩🧱
🧱🟩🟩🧱🧱🧱🧱🟩🟩🟩🟩🧱🟩🟩🧱
🧱🟩🟩🟩🟩🟩🧱🟩🟩🟩🟩🥚🧱🟩🧱
🍳🟩🟩🟩🧱🟩🍳🟩🟩🟩🪹🟩🟩🟩🪹
🧱🟩🟩🟩🧱🟩🟩🟩🟩🟩🥚🟩🟩🟩🧱
🧱🟩🟩🟩🍳🟩🟩🟩🟩🟩🟩🟩🟩🪹🧱
🪹🟩🟩🧱🧱🟩🟩🟩🟩🟩🪹🥚🟩🥚🍳
🧱🧱🧱🧱🧱🧱🧱🧱🪹🧱🧱🍳🍳🧱🧱