35
95
🧱🧱🧱🧱🧱🧱🧱🧱🧱🧱🧱🧱🧱🧱🧱🧱🧱🧱🧱🧱🧱🧱🧱🧱🧱🧱🧱🧱🧱🧱🧱🧱🧱🧱🧱🧱🧱🧱🧱🧱🧱🧱🧱🧱🧱🧱🧱🧱🧱🧱
🧱🥚🧱🟩🟩🟩🧱🟩🟩🟩🟩🟩🟩🟩🟩🟩🟩🟩🧱🟩🟩🟩🟩🟩🟩🟩🧱🟩🟩🟩🟩🟩🟩🟩🟩🟩🟩🟩🟩🟩🟩🟩🟩🟩🟩🟩🟩🟩🟩🧱
🧱🟩🧱🟩🧱🟩🧱🟩🧱🧱🧱🧱🧱🧱🧱🧱🧱🟩🧱🟩🧱🧱🧱🧱🧱🟩🧱🟩🧱🧱🧱🧱🧱🧱🧱🧱🧱🧱🧱🧱🧱🧱🧱🧱🧱🧱🧱🧱🟩🧱
🧱🟩🟩🟩🧱🟩🧱🟩🧱🟩🟩🟩🟩🟩🟩🟩🟩🟩🧱🟩🧱🟩🟩🟩🟩🟩🧱🟩🧱🍳🧱🟩🟩🟩🟩🟩🟩🟩🟩🟩🟩🟩🧱🟩🟩🍳🧱🟩🟩🧱
🧱🧱🧱🧱🧱🟩🧱🟩🧱🟩🧱🧱🧱🧱🧱🧱🧱🧱🧱🟩🧱🟩🧱🧱🧱🧱🧱🟩🧱🟩🧱🟩🧱🧱🧱🧱🧱🧱🧱🧱🧱🟩🧱🟩🧱🧱🧱🟩🧱🧱
🧱🟩🟩🟩🟩🟩🧱🟩🧱🟩🧱🟩🟩🟩🧱🟩🟩🟩🧱🟩🧱🟩🧱🟩🟩🟩🟩🟩🟩🟩🟩🟩🟩🟩🟩🟩🟩🟩🟩🟩🟩🟩🧱🟩🟩🟩🟩🟩🟩🧱
🧱🟩🧱🧱🧱🧱🧱🟩🧱🟩🧱🟩🧱🟩🧱🟩🧱🟩🧱🟩🧱🟩🧱🟩🧱🟩🧱🟩🧱🟩🧱🟩🧱🧱🧱🧱🧱🧱🧱🧱🧱🟩🧱🟩🧱🧱🧱🧱🟩🧱
🧱🟩🟩🟩🟩🟩🟩🟩🧱🟩🧱🟩🧱🟩🧱🟩🧱🟩🧱🟩🧱🟩🧱🟩🧱🟩🧱🟩🧱🟩🧱🟩🧱🟩🟩🟩🟩🟩🟩🟩🟩🟩🟩🟩🟩🟩🍳🧱🟩🧱
🧱🧱🧱🧱🧱🧱🧱🧱🧱🟩🧱🟩🧱🟩🧱🟩🧱🟩🧱🟩🧱🟩🧱🟩🧱🟩🧱🟩🧱🟩🧱🟩🧱🧱🧱🧱🧱🧱🧱🧱🧱🧱🧱🟩🧱🧱🧱🧱🟩🧱
🧱🍳🟩🟩🟩🟩🟩🟩🟩🟩🟩🟩🧱🟩🟩🟩🧱🟩🧱🟩🧱🟩🧱🟩🧱🟩🧱🟩🧱🟩🟩🟩🟩🟩🟩🟩🟩🟩🟩🟩🟩🟩🟩🟩🟩🟩🟩🧱🟩🧱
🧱🧱🧱🧱🧱🧱🧱🧱🧱🧱🧱🧱🧱🧱🧱🧱🧱🟩🧱🟩🧱🟩🧱🟩🧱🟩🧱🟩🧱🟩🧱🧱🧱🧱🧱🧱🧱🧱🧱🧱🧱🧱🧱🧱🧱🧱🟩🧱🟩🧱
🧱🟩🟩🟩🟩🟩🟩🟩🟩🟩🟩🟩🟩🟩🟩🟩🟩🟩🟩🟩🧱🟩🧱🍳🧱🟩🧱🟩🧱🟩🧱🟩🟩🟩🟩🟩🟩🟩🟩🟩🟩🟩🟩🟩🟩🧱🍳🧱🟩🧱
🧱🟩🧱🧱🧱🧱🧱🧱🧱🟩🧱🧱🧱🧱🧱🧱🧱🧱🧱🧱🧱🟩🧱🧱🧱🟩🧱🟩🧱🟩🧱🟩🧱🧱🧱🧱🧱🧱🧱🧱🧱🧱🟩🧱🟩🧱🧱🧱🟩🧱
🧱🟩🟩🟩🟩🟩🟩🟩🧱🟩🧱🍳🟩🟩🟩🟩🟩🟩🟩🟩🟩🟩🟩🟩🟩🟩🧱🟩🧱🟩🧱🟩🧱🟩🟩🟩🟩🟩🟩🟩🟩🟩🟩🧱🟩🟩🟩🧱🟩🧱
🧱🧱🧱🧱🧱🧱🧱🟩🧱🧱🧱🧱🧱🧱🧱🧱🧱🧱🧱🧱🧱🧱🧱🧱🧱🧱🧱🟩🧱🟩🧱🟩🧱🟩🧱🧱🧱🧱🧱🧱🟩🧱🟩🧱🟩🧱🟩🧱🟩🧱
🧱🍳🟩🟩🟩🟩🟩🟩🟩🟩🟩🟩🟩🟩🟩🟩🧱🍳🟩🟩🟩🟩🟩🟩🟩🟩🟩🟩🧱🟩🧱🟩🧱🟩🧱🟩🟩🟩🟩🟩🟩🧱🟩🟩🟩🧱🟩🧱🟩🧱
🧱🧱🧱🧱🧱🧱🧱🧱🧱🧱🧱🟩🧱🧱🧱🟩🧱🧱🧱🧱🧱🧱🧱🧱🧱🟩🧱🧱🧱🟩🧱🟩🧱🟩🧱🟩🧱🧱🧱🧱🧱🧱🟩🧱🧱🧱🟩🧱🟩🧱
🧱🟩🟩🟩🟩🟩🟩🟩🟩🟩🟩🟩🟩🟩🟩🟩🧱🟩🟩🟩🟩🟩🟩🟩🟩🟩🧱🟩🟩🟩🧱🟩🧱🟩🧱🟩🟩🟩🟩🟩🟩🟩🟩🧱🍳🧱🟩🧱🟩🧱
🧱🟩🧱🧱🧱🧱🧱🧱🧱🧱🧱🟩🧱🧱🧱🧱🧱🟩🧱🧱🧱🧱🧱🧱🧱🧱🧱🟩🧱🧱🧱🟩🧱🟩🧱🧱🧱🧱🧱🧱🧱🧱🧱🧱🟩🧱🟩🧱🟩🧱
🧱🟩🟩🟩🟩🟩🟩🟩🟩🟩🟩🟩🟩🟩🟩🟩🟩🟩🧱🟩🟩🟩🟩🟩🟩🟩🟩🟩🟩🟩🟩🟩🟩🟩🟩🟩🟩🟩🟩🟩🟩🟩🟩🟩🟩🧱🟩🟩🟩🧱
🧱🧱🧱🧱🧱🧱🧱🧱🧱🧱🧱🟩🧱🧱🧱🧱🧱🧱🧱🟩🧱🧱🧱🧱🧱🧱🧱🍳🧱🧱🧱🧱🧱🟩🧱🟩🧱🧱🧱🧱🧱🧱🧱🧱🧱🧱🧱🧱🧱🧱
🧱🟩🟩🟩🟩🟩🟩🟩🟩🟩🟩🟩🟩🟩🟩🟩🟩🟩🟩🟩🟩🟩🟩🟩🟩🟩🧱🧱🧱🟩🟩🟩🧱🟩🟩🟩🟩🟩🟩🟩🟩🟩🟩🟩🟩🟩🟩🟩🟩🧱
🧱🟩🧱🧱🧱🧱🧱🧱🧱🧱🧱🧱🧱🧱🧱🧱🧱🧱🧱🟩🧱🧱🧱🧱🧱🟩🧱🍳🧱🟩🧱🟩🧱🧱🧱🟩🧱🧱🧱🧱🧱🧱🧱🧱🧱🧱🧱🧱🟩🧱
🧱🟩🧱🟩🟩🟩🟩🟩🟩🟩🟩🟩🟩🟩🟩🟩🟩🟩🟩🟩🟩🟩🟩🟩🟩🟩🟩🟩🧱🟩🧱🟩🧱🍳🧱🟩🟩🟩🟩🟩🟩🟩🟩🟩🟩🟩🟩🟩🟩🧱
🧱🟩🧱🟩🧱🧱🧱🧱🧱🧱🧱🟩🧱🧱🧱🧱🧱🧱🧱🟩🧱🧱🧱🟩🧱🟩🧱🟩🧱🟩🧱🟩🧱🟩🧱🟩🧱🧱🧱🧱🧱🧱🧱🧱🧱🧱🧱🧱🧱🧱
🧱🟩🧱🟩🧱🟩🟩🟩🟩🟩🟩🟩🟩🟩🟩🟩🟩🟩🟩🟩🟩🟩🟩🟩🧱🟩🧱🟩🧱🟩🧱🟩🧱🟩🧱🟩🧱🟩🟩🟩🟩🟩🟩🟩🟩🟩🟩🟩🟩🧱
🧱🟩🧱🟩🧱🟩🧱🧱🧱🧱🧱🟩🧱🧱🧱🧱🧱🧱🧱🟩🧱🧱🧱🟩🧱🟩🧱🟩🧱🟩🧱🟩🧱🟩🧱🟩🧱🟩🧱🧱🧱🧱🧱🧱🧱🧱🧱🧱🟩🧱
🧱🟩🧱🟩🧱🟩🧱🟩🟩🟩🟩🟩🟩🟩🟩🍳🧱🟩🟩🟩🟩🟩🟩🟩🧱🟩🟩🟩🟩🟩🧱🟩🧱🟩🧱🟩🟩🟩🧱🟩🟩🟩🟩🟩🟩🟩🟩🧱🟩🧱
🧱🟩🧱🟩🧱🟩🧱🟩🧱🟩🧱🟩🧱🧱🧱🧱🧱🟩🧱🟩🧱🧱🧱🧱🧱🧱🧱🟩🧱🧱🧱🟩🧱🟩🧱🧱🧱🧱🧱🟩🧱🧱🧱🧱🧱🧱🟩🟩🟩🧱
🧱🟩🟩🟩🧱🟩🧱🟩🧱🟩🧱🟩🧱🟩🟩🟩🟩🟩🧱🟩🧱🍳🟩🟩🟩🟩🟩🟩🟩🟩🧱🟩🧱🟩🟩🟩🟩🟩🟩🟩🧱🟩🟩🟩🟩🟩🟩🧱🧱🧱
🧱🧱🧱🟩🧱🟩🧱🟩🧱🟩🧱🟩🧱🟩🧱🧱🧱🧱🧱🟩🧱🧱🟩🧱🧱🧱🧱🟩🧱🟩🧱🟩🧱🟩🧱🧱🧱🧱🟩🟩🧱🟩🧱🧱🧱🧱🧱🧱🍳🧱
🧱🟩🟩🟩🟩🟩🧱🟩🧱🟩🧱🟩🟩🟩🟩🟩🟩🍳🧱🟩🟩🟩🟩🟩🟩🟩🧱🟩🧱🟩🟩🟩🟩🟩🟩🟩🟩🟩🟩🧱🧱🟩🟩🟩🟩🟩🟩🟩🟩🧱
🧱🟩🧱🟩🧱🟩🧱🟩🧱🟩🧱🟩🧱🧱🧱🧱🧱🧱🧱🧱🟩🧱🧱🧱🧱🟩🧱🟩🧱🟩🧱🟩🧱🧱🧱🧱🧱🧱🧱🧱🧱🧱🧱🧱🧱🧱🧱🧱🟩🧱
🧱🟩🟩🟩🧱🍳🧱🪹🧱🟩🟩🟩🟩🟩🟩🟩🟩🟩🟩🟩🟩🧱🍳🟩🟩🟩🟩🟩🟩🟩🧱🟩🟩🟩🟩🟩🟩🟩🟩🟩🟩🟩🟩🟩🟩🟩🟩🟩🟩🧱
🧱🧱🧱🧱🧱🧱🧱🧱🧱🧱🧱🧱🧱🧱🧱🧱🧱🧱🧱🧱🧱🧱🧱🧱🧱🧱🧱🧱🧱🧱🧱🧱🧱🧱🧱🧱🧱🧱🧱🧱🧱🧱🧱🧱🧱🧱🧱🧱🧱🧱